....#...............
..........#.........
##...#.....#...#....
..T...#........##.#.
#...................
#..#....#..........#
.........##..T.....#
.......##..#.....#..
......#...#.#.......
..........#..#..#...
.....#..............
#........#..#...##..
#...#.........#.#...
#....#............#.
................#...
..............#.....
.......#..#..#......
................##..
............#.......
.....##............#
