.....#..#..##...#........
......#.......##...##....
.........#.......#.......
.#...#.#.................
.......................#.
.......##..#.......#.#...
.....#..............##...
................##.#.....
#..#......#..........#...
.##....................#.
#....###.#T#......#..##..
...#.#...#...............
..##....##.........#.#...
#...#.....#..#.....#...#.
........#....#..#...#.#..
..##..#.#...#....#.......
.#.........#....#........
............#............
.................#.......
......#...........#....#.
......#..........##.#.#..
..##.....##...#...#.#....
.......#...#...........#.
.#.#.#.....T....#.#......
......#..................
